{
  "name": "Intro Box",
  "layout": [
    "####################",
    "#P.................#",
    "#..................#",
    "#..................#",
    "#.........B..X.....#",
    "#..................#",
    "#..................#",
    "#..................#",
    "#..................#",
    "#..................#",
    "#..................#",
    "#..................#",
    "#..................#",
    "#..................#",
    "#..................#",
    "####################"
  ]
}
