{
  "name": "Block Parade",
  "layout": [
    "####################",
    "#P..M...M...M......#",
    "#..................#",
    "#..................#",
    "#..####............#",
    "#..B......X........#",
    "#..####............#",
    "#..................#",
    "#..M.......M.......#",
    "#..................#",
    "#..................#",
    "#..................#",
    "#..................#",
    "#..................#",
    "#..................#",
    "####################"
  ]
}
