{
  "name": "Mind Bender",
  "layout": [
    "####################",
    "#P.......##.......M#",
    "#.###.###.##.###.###",
    "#.....#.......#....#",
    "###.#.#####.#.###.##",
    "#M..#..B..#.#....#X#",
    "##.#####.#.#.###.#.#",
    "#.......#.#.....#.##",
    "#.#####.#.#####.#.##",
    "#.#...#.#.....#.#.##",
    "#.#.#.#.#####.#.#.##",
    "#.#.#.#.......#.#.##",
    "#.#.#.#########.#.##",
    "#...#...........#.##",
    "###.###.#####.###.##",
    "####################"
  ]
}