{
  "name": "Intro Box",
  "layout": [
    "####################",
    "#P..E.......####.X.#",
    "#..............##E##",
    "#..............#...#",
    "#..............#...#",
    "#..............#.B.#",
    "#......####....#...#",
    "#..............#...#",
    "#......##E#....#...#",
    "#......##.#....#...#",
    "#..................#",
    "#..................#",
    "#..................#",
    "#..................#",
    "#..................#",
    "####################"
  ]
}
